Fecha;Cuenta Contable;Tipo Movimiento;"Clasificación;Documento Fiscal;Centro de Costo";Valor;Saldo
2/1/2022;101;Entrada;"Ingresos por ventas ;1008792;198503";92982;92982
2/1/2022;201;Entrada;"Ingresos por ventas ;1008793;198505";99320;192302
2/1/2022;101;Entrada;"Ingresos por ventas ;1008547;198501";83762;276064
2/1/2022;202;Salida;"Gastos administrativos;1008790;198503";51906;224158
3/1/2022;201;Entrada;"Ingresos por ventas;1008548;198504";94420;318578
3/1/2022;301;Salida;"Gastos administrativos;1008791;198504";51781;266797
3/1/2022;101;Entrada;"Ingresos por ventas;1008549;198505";94077;360874
3/1/2022;202;Salida;"Gastos administrativos;1008794;198505";50275;310599
4/1/2022;301;Salida;"Gastos administrativos;1008795;198501";82106;228493
4/1/2022;301;Entrada;"Ingresos por ventas ;1008550;198504";86374;314867
4/1/2022;202;Entrada;"Ingresos por ventas ;1008552;198502";66610;381477
4/1/2022;101;Entrada;"Ingresos por ventas ;1008552;198502";80141;461618
5/1/2022;101;Salida;"Gastos comerciales;1008796;198504";54032;407586
5/1/2022;201;Salida;"Gastos comerciales;1008797;198502";54031;353555
5/1/2022;201;Salida;"Gastos en servicios;1008553;198504";52038;301517
5/1/2022;301;Entrada;"Ingresos por ventas;1008554;198501";67137;368654
5/1/2022;101;Entrada;"Ingresos por ventas ;1008555;198504";79749;448403
5/1/2022;202;Salida;"Gastos administrativos;1008556;198503";55082;393321
6/1/2022;202;Salida;"Gastos comerciales;1008798;198501";52600;340721
6/1/2022;301;Salida;"Gastos comerciales;1008799;198505";52807;287914
7/1/2022;101;Entrada;"Ingresos por ventas ;1008557;198503";84340;372254
7/1/2022;101;Entrada;"Ingresos por ventas ;1008800;198501";84988;457242
10/1/2022;201;Entrada;"Ingresos por ventas ;1008801;198503";96627;553869
10/1/2022;201;Salida;"Gastos en servicios;1008558;198502";77081;476788
10/1/2022;301;Entrada;"Ingresos por ventas;1008559;198503";80768;557556
10/1/2022;202;Salida;"Gastos en servicios;1008802;198502";26327;531229
10/1/2022;301;Salida;"Gastos en servicios;1008803;198502";37759;493470
10/1/2022;101;Entrada;"Ingresos por ventas ;1008560;198502";77922;571392
11/1/2022;202;Salida;"Gastos administrativos;1008561;198504";86276;485116
11/1/2022;101;Salida;"Gastos administrativos;1008804;198504";85066;400050
12/1/2022;201;Salida;"Gastos administrativos;1008805;198505";24979;375071
12/1/2022;202;Salida;"Gastos administrativos;1008806;198505";81166;293905
13/1/2022;301;Salida;"Gastos administrativos;1008807;198501";29272;264633
13/1/2022;101;Entrada;"Ingresos por ventas ;1008562;198501";92880;357513
14/1/2022;201;Entrada;"Ingresos por ventas ;1008562;198501";95108;452621
14/1/2022;301;Entrada;"Ingresos por ventas;1008564;198504";69543;522164
16/1/2022;101;Entrada;"Otros ingresos;1008808;198503";51127;573291
16/1/2022;201;Entrada;"Otros ingresos;1008809;198504";48394;621685
16/1/2022;101;Entrada;"Ingresos por ventas ;1008565;198505";62634;684319
16/1/2022;202;Entrada;"Ingresos por ventas ;1008562;198501";76347;760666
17/1/2022;202;Entrada;"Ingresos por ventas;1008810;198505";97821;858487
17/1/2022;301;Entrada;"Ingresos por ventas;1008811;198504";87370;945857
17/1/2022;101;Entrada;"Ingresos por ventas ;1008567;198505";83707;1029564
17/1/2022;101;Entrada;"Ingresos por ventas ;1008568;198505";71735;1101299
17/1/2022;201;Salida;"Gastos en servicios;1008569;198502";33722;1067577
17/1/2022;101;Entrada;"Ingresos por ventas;1008570;198505";67587;1135164
18/1/2022;301;Entrada;"Ingresos por ventas ;1008571;198501";74172;1209336
18/1/2022;101;Entrada;"Ingresos por ventas;1008812;198501";86994;1296330
19/1/2022;201;Entrada;"Ingresos por ventas;1008813;198503";69697;1366027
19/1/2022;202;Salida;"Gastos administrativos;1008572;198503";24272;1341755
19/1/2022;101;Entrada;"Ingresos por ventas ;1008573;198501";66378;1408133
19/1/2022;202;Salida;"Gastos de personal;1008814;198505";18189;1389944
19/1/2022;301;Salida;"Gastos de personal;1008815;198501";84781;1305163
19/1/2022;201;Entrada;"Ingresos por ventas ;1008562;198501";69272;1374435
20/1/2022;301;Entrada;"Ingresos por ventas;1008575;198502";81547;1455982
20/1/2022;101;Salida;"Gastos en servicios;1008816;198502";51428;1404554
21/1/2022;201;Salida;"Gastos en servicios;1008817;198502";21863;1382691
21/1/2022;101;Entrada;"Ingresos por ventas ;1008576;198503";83805;1466496
23/1/2022;202;Salida;"Impuestos;1008818;198504";45226;1421270
23/1/2022;301;Salida;"Impuestos;1008819;198502";46653;1374617
23/1/2022;202;Salida;"Gastos administrativos;1008577;198501";28808;1345809
23/1/2022;101;Salida;"Gastos de personal;1008820;198503";86331;1259478
23/1/2022;201;Salida;"Gastos de personal;1008821;198502";85972;1173506
23/1/2022;101;Entrada;"Ingresos por ventas ;1008578;198501";82172;1255678
23/1/2022;202;Salida;"Gastos comerciales;1008822;198505";82005;1173673
23/1/2022;301;Salida;"Gastos comerciales;1008823;198502";83554;1090119
24/1/2022;201;Salida;"Gastos en servicios;1008579;198505";33485;1056634
24/1/2022;301;Entrada;"Ingresos por ventas;1008580;198502";85179;1141813
25/1/2022;101;Entrada;"Ingresos por ventas ;1008581;198503";62891;1204704
25/1/2022;202;Entrada;"Ingresos por ventas;1008582;198502";65589;1270293
26/1/2022;101;Entrada;"Ingresos por ventas ;1008583;198503";90101;1360394
26/1/2022;201;Salida;"Gastos en servicios;1008584;198504";81036;1279358
26/1/2022;301;Entrada;"Ingresos por ventas;1008585;198505";91168;1370526
26/1/2022;101;Entrada;"Ingresos por ventas ;1008586;198504";74666;1445192
26/1/2022;202;Entrada;"Ingresos por ventas ;1008562;198501";78680;1523872
26/1/2022;101;Salida;"Gastos en servicios;1008824;198502";21836;1502036
27/1/2022;201;Salida;"Gastos en servicios;1008825;198505";55505;1446531
27/1/2022;202;Entrada;"Otros ingresos;1008826;198502";39057;1485588
28/1/2022;301;Entrada;"Otros ingresos;1008827;198502";55539;1541127
28/1/2022;201;Entrada;"Ingresos por ventas ;1008829;198501";98205;1639332
28/1/2022;301;Entrada;"Ingresos por ventas ;1008831;198504";91425;1730757
28/1/2022;101;Salida;"Gastos administrativos;1008828;198502";29340;1701417
28/1/2022;202;Salida;"Gastos administrativos;1008830;198501";28998;1672419
28/1/2022;101;Salida;"Gastos comerciales;1008832;198503";81951;1590468
31/1/2022;201;Salida;"Gastos comerciales;1008833;198504";82399;1508069
31/1/2022;202;Salida;"Gastos de personal;1008834;198504";86765;1421304
1/2/2022;301;Salida;"Gastos de personal;1008835;198505";83673;1337631
1/2/2022;101;Salida;"Gastos comerciales;1008836;198504";84254;1253377
2/2/2022;201;Salida;"Gastos comerciales;1008837;198501";91450;1161927
2/2/2022;202;Entrada;"Ingresos por ventas ;1008838;198503";74235;1236162
3/2/2022;301;Entrada;"Ingresos por ventas ;1008839;198502";97932;1334094
3/2/2022;101;Salida;"Gastos administrativos;1008840;198504";23539;1310555
4/2/2022;201;Salida;"Gastos administrativos;1008841;198505";23899;1286656
4/2/2022;202;Salida;"Gastos administrativos;1008842;198502";25414;1261242
7/2/2022;301;Salida;"Gastos administrativos;1008843;198504";19645;1241597
7/2/2022;101;Salida;"Gastos de personal;1008844;198503";17572;1224025
7/2/2022;201;Salida;"Gastos de personal;1008845;198501";86996;1137029
7/2/2022;202;Salida;"Gastos de personal;1008846;198501";82748;1054281
7/2/2022;301;Salida;"Gastos de personal;1008847;198505";18223;1036058
7/2/2022;101;Salida;"Gastos administrativos;1008848;198504";81189;954869
8/2/2022;201;Salida;"Gastos administrativos;1008849;198502";87126;867743
8/2/2022;202;Entrada;"Ingresos por ventas ;1008850;198502";71495;939238
8/2/2022;301;Entrada;"Ingresos por ventas ;1008851;198505";86298;1025536
8/2/2022;101;Entrada;"Ingresos por ventas ;1008852;198501";87752;1113288
8/2/2022;201;Entrada;"Ingresos por ventas ;1008853;198504";89876;1203164
8/2/2022;202;Salida;"Gastos de personal;1008854;198503";18204;1184960
9/2/2022;301;Salida;"Gastos de personal;1008855;198502";82866;1102094
9/2/2022;101;Salida;"Gastos administrativos;1008856;198504";23217;1078877
10/2/2022;201;Salida;"Gastos administrativos;1008857;198504";17731;1061146
10/2/2022;202;Salida;"Gastos administrativos;1008858;198501";28537;1032609
10/2/2022;301;Salida;"Gastos administrativos;1008859;198502";83489;949120
10/2/2022;101;Entrada;"Otros ingresos;1008860;198504";46055;995175
10/2/2022;201;Entrada;"Otros ingresos;1008861;198504";47015;1042190
10/2/2022;202;Entrada;"Ingresos por ventas ;1008862;198504";81227;1123417
11/2/2022;301;Entrada;"Ingresos por ventas ;1008863;198505";68984;1192401
11/2/2022;201;Entrada;"Ingresos por ventas ;1008865;198501";78143;1270544
13/2/2022;301;Entrada;"Ingresos por ventas ;1008867;198502";86541;1357085
13/2/2022;101;Salida;"Gastos de personal;1008864;198501";25558;1331527
13/2/2022;202;Salida;"Gastos de personal;1008866;198501";23124;1308403
13/2/2022;101;Salida;"Impuestos;1008868;198505";57743;1250660
14/2/2022;202;Salida;"Impuestos;1008870;198501";52017;1198643
14/2/2022;201;Salida;"Gastos comerciales;1008869;198502";91032;1107611
14/2/2022;301;Salida;"Gastos comerciales;1008871;198501";81519;1026092
14/2/2022;101;Entrada;"Ingresos por ventas ;1008872;198505";97808;1123900
14/2/2022;201;Entrada;"Ingresos por ventas ;1008873;198501";61265;1185165
14/2/2022;202;Salida;"Gastos en servicios;1008874;198504";33473;1151692
15/2/2022;301;Salida;"Gastos en servicios;1008875;198503";66151;1085541
15/2/2022;101;Salida;"Gastos comerciales;1008876;198502";93305;992236
15/2/2022;201;Salida;"Gastos comerciales;1008877;198504";92642;899594
15/2/2022;202;Entrada;"Otros ingresos;1008878;198502";33335;932929
15/2/2022;101;Entrada;"Otros ingresos;1008880;198505";40030;972959
15/2/2022;301;Salida;"Gastos en servicios;1008879;198503";81765;891194
16/2/2022;201;Salida;"Gastos en servicios;1008881;198501";84663;806531
16/2/2022;202;Salida;"Gastos en servicios;1008882;198502";33507;773024
17/2/2022;301;Salida;"Gastos en servicios;1008883;198503";21849;751175
17/2/2022;101;Salida;"Gastos administrativos;1008884;198501";22666;728509
18/2/2022;201;Salida;"Gastos administrativos;1008885;198502";19275;709234
18/2/2022;202;Salida;"Gastos administrativos;1008886;198503";93249;615985
21/2/2022;301;Salida;"Gastos administrativos;1008887;198504";18426;597559
21/2/2022;101;Salida;"Gastos administrativos;1008888;198505";21952;575607
22/2/2022;201;Salida;"Gastos administrativos;1008889;198502";18438;557169
22/2/2022;202;Entrada;"Ingresos por ventas ;1008890;198502";76503;633672
23/2/2022;301;Entrada;"Ingresos por ventas ;1008891;198505";84224;717896
23/2/2022;101;Salida;"Gastos comerciales;1008892;198505";24728;693168
24/2/2022;201;Salida;"Gastos comerciales;1008893;198505";21370;671798
24/2/2022;301;Salida;"Gastos comerciales;1008895;198504";24054;647744
25/2/2022;201;Salida;"Gastos comerciales;1008897;198502";24278;623466
25/2/2022;202;Salida;"Gastos en servicios;1008894;198501";91303;532163
28/2/2022;101;Salida;"Gastos en servicios;1008896;198501";55958;476205
28/2/2022;202;Salida;"Gastos en servicios;1008898;198505";56581;419624
28/2/2022;301;Salida;"Gastos en servicios;1008899;198503";84069;335555
28/2/2022;101;Salida;"Gastos en servicios;1008900;198503";57622;277933
28/2/2022;201;Salida;"Gastos en servicios;1008901;198503";23806;254127
28/2/2022;202;Salida;"Gastos en servicios;1008902;198505";54930;199197
1/3/2022;301;Salida;"Gastos en servicios;1008903;198503";55440;143757
1/3/2022;101;Salida;"Gastos administrativos;1008904;198503";19874;123883
6/3/2022;201;Salida;"Gastos administrativos;1008905;198504";25119;98764
6/3/2022;202;Entrada;"Ingresos por ventas ;1008906;198501";57805;156569
6/3/2022;301;Entrada;"Ingresos por ventas ;1008907;198504";58112;214681
6/3/2022;101;Entrada;"Otros ingresos;1008908;198505";59268;273949
7/3/2022;202;Entrada;"Otros ingresos;1008910;198501";32946;306895
7/3/2022;201;Salida;"Gastos comerciales;1008909;198502";22277;284618
7/3/2022;301;Salida;"Gastos comerciales;1008911;198502";23945;260673
7/3/2022;101;Salida;"Gastos administrativos;1008912;198502";81483;179190
7/3/2022;201;Salida;"Gastos administrativos;1008913;198501";17934;161256
7/3/2022;202;Salida;"Gastos en servicios;1008914;198502";56225;105031
7/3/2022;301;Salida;"Gastos en servicios;1008915;198504";76303;28728
7/3/2022;101;Entrada;"Ingresos por ventas ;1008916;198502";66121;94849
10/3/2022;201;Entrada;"Ingresos por ventas ;1008917;198502";72968;167817
10/3/2022;202;Salida;"Gastos comerciales;1008918;198502";21729;146088
10/3/2022;301;Salida;"Gastos comerciales;1008919;198505";23612;122476
10/3/2022;101;Salida;"Impuestos;1008920;198502";59632;62844
14/3/2022;202;Salida;"Impuestos;1008922;198503";59151;3693
14/3/2022;201;Salida;"Gastos de personal;1008921;198503";24065;-20372
14/3/2022;301;Salida;"Gastos de personal;1008923;198504";23999;-44371
14/3/2022;101;Entrada;"Ingresos por ventas;1008924;198502";85500;41129
18/3/2022;201;Entrada;"Ingresos por ventas;1008925;198502";62496;103625
18/3/2022;202;Salida;"Gastos de personal;1008926;198501";22177;81448
18/3/2022;301;Entrada;"Ingresos por ventas;1008927;198505";19796;101244
18/3/2022;101;Entrada;"Ingresos por ventas;1008928;198503";81727;182971
19/3/2022;201;Entrada;"Ingresos por ventas;1008929;198503";55641;238612
19/3/2022;202;Entrada;"Ingresos por ventas;1008930;198503";54523;293135
19/3/2022;301;Entrada;"Ingresos por ventas;1008931;198502";33008;326143
19/3/2022;201;Entrada;"Ingresos por ventas;1008933;198505";23941;350084
27/3/2022;301;Entrada;"Ingresos por ventas;1008935;198502";23049;373133
27/3/2022;101;Salida;"Gastos de personal;1008932;198505";24151;348982
27/3/2022;202;Salida;"Gastos de personal;1008934;198501";96911;252071
27/3/2022;101;Entrada;"Ingresos por ventas;1008936;198501";57711;309782
27/3/2022;201;Entrada;"Ingresos por ventas;1008937;198504";92052;401834
27/3/2022;202;Salida;"Gastos de personal;1008938;198501";94262;307572
27/3/2022;301;Salida;"Gastos de personal;1008939;198503";21215;286357
27/3/2022;101;Salida;"Gastos administrativos;1008940;198503";93210;193147
29/3/2022;201;Salida;"Gastos administrativos;1008941;198502";28766;164381
29/3/2022;202;Salida;"Gastos en servicios;1008942;198502";25660;138721
29/3/2022;301;Salida;"Gastos en servicios;1008943;198502";22750;115971
29/3/2022;202;Entrada;"Otros ingresos;1008946;198501";33319;149290
7/4/2022;301;Entrada;"Otros ingresos;1008947;198501";33264;182554
7/4/2022;202;Entrada;"Otros ingresos;1008950;198505";54159;236713
7/4/2022;301;Entrada;"Otros ingresos;1008951;198505";22728;259441
7/4/2022;101;Entrada;"Otros ingresos;1008952;198503";27470;286911
13/4/2022;201;Entrada;"Otros ingresos;1008953;198503";28254;315165
13/4/2022;202;Entrada;"Otros ingresos;1008954;198503";92467;407632
13/4/2022;301;Salida;"Gastos administrativos;1008955;198501";27757;379875
13/4/2022;201;Entrada;"Otros ingresos;1008957;198501";28129;408004
14/4/2022;202;Entrada;"Otros ingresos;1008958;198503";29767;437771
14/4/2022;101;Entrada;"Otros ingresos;1008960;198504";55399;493170
14/4/2022;201;Entrada;"Otros ingresos;1008961;198505";52573;545743
14/4/2022;202;Salida;"Gastos administrativos;1008962;198501";22468;523275
14/4/2022;301;Entrada;"Otros ingresos;1008963;198502";23155;546430
14/4/2022;101;Entrada;"Otros ingresos;1008964;198501";93668;640098
14/4/2022;201;Entrada;"Otros ingresos;1008965;198504";81736;721834
14/4/2022;202;Entrada;"Otros ingresos;1008966;198502";23974;745808
15/4/2022;301;Salida;"Gastos administrativos;1008967;198505";17263;728545
15/4/2022;201;Salida;"Gastos comerciales;1008969;198501";22024;706521
15/4/2022;301;Salida;"Gastos comerciales;1008971;198502";22939;683582
15/4/2022;101;Salida;"Gastos en servicios;1008968;198503";21932;661650
17/4/2022;202;Salida;"Gastos en servicios;1008970;198501";54724;606926
17/4/2022;202;Salida;"Gastos en servicios;1008974;198503";33662;573264
17/4/2022;301;Salida;"Gastos en servicios;1008975;198501";54181;519083
17/4/2022;101;Salida;"Gastos administrativos;1008976;198504";93068;426015
23/4/2022;201;Salida;"Gastos administrativos;1008977;198502";51331;374684
23/4/2022;101;Entrada;"Otros ingresos;1008980;198505";32135;406819
23/4/2022;201;Entrada;"Otros ingresos;1008981;198505";35843;442662
23/4/2022;202;Salida;"Gastos comerciales;1008982;198502";81400;361262
25/4/2022;301;Salida;"Gastos comerciales;1008983;198503";93473;267789
25/4/2022;202;Salida;"Gastos administrativos;1008986;198504";54044;213745
25/4/2022;301;Salida;"Gastos administrativos;1008987;198502";54741;159004
25/4/2022;101;Entrada;"Ingresos por ventas ;1008588;198501";66418;225422
1/5/2022;301;Salida;"Gastos administrativos;1008611;198505";66841;158581
1/5/2022;202;Entrada;"Ingresos por ventas;1008641;198504";89628;248209
1/5/2022;101;Entrada;"Ingresos por ventas ;1008663;198501";56429;304638
1/5/2022;201;Salida;"Gastos en servicios;1008684;198504";25862;278776
4/5/2022;101;Entrada;"Ingresos por ventas ;1008707;198504";93507;372283
4/5/2022;101;Entrada;"Ingresos por ventas ;1008748;198503";84769;457052
4/5/2022;101;Entrada;"Ingresos por ventas ;1008768;198503";81176;538228
4/5/2022;201;Entrada;"Ingresos por ventas ;1008562;198501";98376;636604
4/5/2022;101;Entrada;"Ingresos por ventas ;1008619;198502";95295;731899
4/5/2022;301;Salida;"Gastos administrativos;1008642;198503";33960;697939
4/5/2022;202;Entrada;"Ingresos por ventas;1008685;198503";80697;778636
4/5/2022;201;Salida;"Gastos en servicios;1008708;198501";96494;682142
9/5/2022;201;Salida;"Gastos en servicios;1008769;198502";21531;660611
9/5/2022;202;Entrada;"Ingresos por ventas;1008590;198502";66749;727360
9/5/2022;201;Salida;"Gastos en servicios;1008620;198501";81007;646353
9/5/2022;101;Entrada;"Ingresos por ventas ;1008643;198502";60880;707233
9/5/2022;301;Salida;"Gastos administrativos;1008686;198505";33110;674123
9/5/2022;201;Salida;"Gastos en servicios;1008728;198502";84417;589706
9/5/2022;201;Salida;"Gastos en servicios;1008749;198504";84480;505226
9/5/2022;301;Salida;"Gastos administrativos;1008591;198504";81797;423429
10/5/2022;101;Entrada;"Ingresos por ventas ;1008612;198503";67526;490955
10/5/2022;202;Entrada;"Ingresos por ventas;1008621;198504";68839;559794
10/5/2022;201;Salida;"Gastos en servicios;1008664;198501";22615;537179
10/5/2022;101;Entrada;"Ingresos por ventas ;1008687;198504";68265;605444
14/5/2022;202;Entrada;"Ingresos por ventas;1008729;198503";78985;684429
14/5/2022;202;Entrada;"Ingresos por ventas;1008750;198503";96920;781349
14/5/2022;201;Salida;"Gastos en servicios;1008613;198504";96961;684388
14/5/2022;301;Salida;"Gastos administrativos;1008622;198502";85041;599347
24/5/2022;202;Entrada;"Ingresos por ventas;1008665;198505";82469;681816
24/5/2022;201;Salida;"Gastos en servicios;1008688;198503";33877;647939
24/5/2022;202;Entrada;"Ingresos por ventas;1008709;198505";63225;711164
24/5/2022;301;Salida;"Gastos administrativos;1008730;198505";89225;621939
28/5/2022;202;Entrada;"Ingresos por ventas;1008770;198503";74426;696365
28/5/2022;202;Entrada;"Ingresos por ventas;1008614;198502";60402;756767
28/5/2022;101;Entrada;"Ingresos por ventas ;1008623;198504";98928;855695
28/5/2022;201;Salida;"Gastos en servicios;1008644;198501";33543;822152
28/5/2022;301;Salida;"Gastos administrativos;1008666;198501";98272;723880
28/5/2022;301;Salida;"Gastos administrativos;1008710;198505";59631;664249
28/5/2022;101;Entrada;"Ingresos por ventas ;1008731;198505";81241;745490
28/5/2022;301;Salida;"Gastos administrativos;1008771;198501";81368;664122
5/6/2022;101;Entrada;"Ingresos por ventas ;1008592;198503";96804;760926
5/6/2022;301;Salida;"Gastos administrativos;1008615;198501";81022;679904
5/6/2022;202;Entrada;"Ingresos por ventas;1008645;198505";68333;748237
5/6/2022;101;Entrada;"Ingresos por ventas ;1008667;198504";84228;832465
6/6/2022;201;Salida;"Gastos en servicios;1008732;198504";33146;799319
6/6/2022;301;Salida;"Gastos administrativos;1008751;198502";22437;776882
6/6/2022;101;Entrada;"Ingresos por ventas ;1008772;198503";86224;863106
6/6/2022;201;Salida;"Gastos en servicios;1008593;198501";77013;786093
8/6/2022;101;Entrada;"Ingresos por ventas ;1008616;198504";90442;876535
8/6/2022;301;Salida;"Gastos administrativos;1008646;198505";77510;799025
8/6/2022;201;Salida;"Gastos en servicios;1008668;198503";77341;721684
8/6/2022;202;Entrada;"Ingresos por ventas;1008689;198501";83021;804705
8/6/2022;101;Entrada;"Ingresos por ventas ;1008711;198505";83894;888599
8/6/2022;101;Entrada;"Ingresos por ventas ;1008752;198501";90223;978822
8/6/2022;201;Salida;"Gastos en servicios;1008773;198503";85985;892837
8/6/2022;202;Entrada;"Ingresos por ventas;1008594;198503";84544;977381
10/6/2022;201;Salida;"Gastos en servicios;1008624;198501";25771;951610
10/6/2022;101;Entrada;"Ingresos por ventas ;1008647;198504";62431;1014041
10/6/2022;301;Salida;"Gastos administrativos;1008690;198505";22207;991834
10/6/2022;201;Salida;"Gastos en servicios;1008712;198503";23557;968277
11/6/2022;201;Salida;"Gastos en servicios;1008753;198504";84472;883805
11/6/2022;202;Entrada;"Ingresos por ventas;1008774;198502";71989;955794
11/6/2022;301;Salida;"Gastos administrativos;1008595;198505";91662;864132
11/6/2022;202;Entrada;"Ingresos por ventas;1008625;198504";60790;924922
14/6/2022;201;Salida;"Gastos en servicios;1008648;198505";85759;839163
14/6/2022;101;Entrada;"Ingresos por ventas ;1008691;198501";59849;899012
14/6/2022;202;Entrada;"Ingresos por ventas;1008733;198504";79122;978134
14/6/2022;202;Entrada;"Ingresos por ventas;1008754;198504";61932;1040066
14/6/2022;101;Entrada;"Ingresos por ventas ;1008596;198503";62107;1102173
14/6/2022;201;Salida;"Gastos en servicios;1008617;198504";33855;1068318
14/6/2022;301;Salida;"Gastos administrativos;1008626;198501";87309;981009
14/6/2022;202;Entrada;"Ingresos por ventas;1008669;198503";75795;1056804
17/6/2022;201;Salida;"Gastos en servicios;1008692;198504";26798;1030006
17/6/2022;301;Salida;"Gastos administrativos;1008734;198503";91436;938570
17/6/2022;301;Salida;"Gastos administrativos;1008755;198503";33089;905481
17/6/2022;202;Entrada;"Ingresos por ventas;1008618;198502";95759;1001240
18/6/2022;101;Entrada;"Ingresos por ventas ;1008627;198505";93679;1094919
18/6/2022;301;Salida;"Gastos administrativos;1008670;198505";91474;1003445
18/6/2022;202;Entrada;"Ingresos por ventas;1008693;198504";83821;1087266
18/6/2022;202;Entrada;"Ingresos por ventas;1008713;198501";84496;1171762
22/6/2022;301;Salida;"Gastos administrativos;1008775;198505";33705;1138057
22/6/2022;201;Entrada;"Ingresos por ventas;1008628;198505";76436;1214493
22/6/2022;202;Entrada;"Ingresos por ventas;1008649;198504";77737;1292230
22/6/2022;101;Entrada;"Ingresos por ventas ;1008671;198505";90855;1383085
1/7/2022;301;Salida;"Gastos administrativos;1008714;198503";86547;1296538
1/7/2022;101;Entrada;"Ingresos por ventas ;1008735;198502";79285;1375823
1/7/2022;101;Entrada;"Ingresos por ventas ;1008776;198502";82278;1458101
1/7/2022;201;Salida;"Gastos en servicios;1008597;198502";91087;1367014
3/7/2022;301;Salida;"Gastos administrativos;1008650;198505";33412;1333602
3/7/2022;201;Salida;"Gastos en servicios;1008672;198502";71767;1261835
3/7/2022;101;Entrada;"Ingresos por ventas ;1008715;198502";85711;1347546
3/7/2022;201;Salida;"Gastos en servicios;1008736;198505";33534;1314012
5/7/2022;101;Entrada;"Ingresos por ventas ;1008756;198503";96833;1410845
5/7/2022;201;Salida;"Gastos en servicios;1008777;198502";21820;1389025
5/7/2022;202;Entrada;"Ingresos por ventas;1008598;198501";92312;1481337
5/7/2022;101;Entrada;"Ingresos por ventas ;1008651;198505";80076;1561413
5/7/2022;202;Entrada;"Ingresos por ventas;1008673;198505";67060;1628473
5/7/2022;301;Salida;"Gastos administrativos;1008694;198501";22741;1605732
5/7/2022;201;Salida;"Gastos en servicios;1008716;198504";84878;1520854
5/7/2022;202;Entrada;"Ingresos por ventas;1008778;198501";93274;1614128
16/7/2022;301;Salida;"Gastos administrativos;1008599;198501";78618;1535510
16/7/2022;202;Entrada;"Ingresos por ventas;1008629;198501";62870;1598380
16/7/2022;201;Salida;"Gastos en servicios;1008652;198504";85104;1513276
16/7/2022;101;Entrada;"Ingresos por ventas ;1008695;198501";93842;1607118
27/7/2022;202;Entrada;"Ingresos por ventas;1008717;198502";93209;1700327
27/7/2022;201;Salida;"Gastos en servicios;1008757;198502";26750;1673577
27/7/2022;301;Salida;"Gastos administrativos;1008779;198502";55354;1618223
27/7/2022;101;Entrada;"Ingresos por ventas ;1008600;198502";99993;1718216
29/7/2022;301;Salida;"Gastos administrativos;1008630;198503";81587;1636629
29/7/2022;202;Entrada;"Ingresos por ventas;1008653;198502";86358;1722987
29/7/2022;201;Salida;"Gastos en servicios;1008696;198504";88734;1634253
29/7/2022;202;Entrada;"Ingresos por ventas;1008737;198502";89584;1723837
1/8/2022;202;Entrada;"Ingresos por ventas;1008758;198505";82909;1806746
1/8/2022;201;Entrada;"Ingresos por ventas;1008601;198501";84587;1891333
1/8/2022;101;Entrada;"Ingresos por ventas ;1008631;198505";77184;1968517
1/8/2022;301;Salida;"Gastos administrativos;1008674;198503";89225;1879292
2/8/2022;202;Entrada;"Ingresos por ventas;1008697;198504";71109;1950401
2/8/2022;301;Salida;"Gastos administrativos;1008738;198501";33620;1916781
2/8/2022;301;Salida;"Gastos administrativos;1008759;198503";76237;1840544
2/8/2022;201;Salida;"Gastos en servicios;1008632;198502";22453;1818091
2/8/2022;101;Entrada;"Ingresos por ventas ;1008675;198505";90990;1909081
2/8/2022;301;Salida;"Gastos administrativos;1008698;198505";81255;1827826
2/8/2022;301;Salida;"Gastos administrativos;1008718;198501";76307;1751519
2/8/2022;101;Entrada;"Ingresos por ventas ;1008739;198505";64720;1816239
5/8/2022;101;Entrada;"Ingresos por ventas ;1008780;198503";92198;1908437
5/8/2022;202;Entrada;"Ingresos por ventas;1008633;198502";79640;1988077
5/8/2022;301;Entrada;"Ingresos por ventas;1008654;198503";60021;2048098
5/8/2022;201;Salida;"Gastos en servicios;1008676;198505";22622;2025476
11/8/2022;101;Entrada;"Ingresos por ventas ;1008719;198503";80507;2105983
11/8/2022;201;Salida;"Gastos en servicios;1008740;198501";76778;2029205
11/8/2022;201;Salida;"Gastos en servicios;1008781;198502";22972;2006233
11/8/2022;202;Entrada;"Ingresos por ventas;1008602;198503";82238;2088471
18/8/2022;101;Entrada;"Ingresos por ventas ;1008655;198505";71276;2159747
18/8/2022;202;Entrada;"Ingresos por ventas;1008677;198501";83101;2242848
18/8/2022;201;Salida;"Gastos en servicios;1008720;198505";85425;2157423
18/8/2022;202;Entrada;"Ingresos por ventas;1008741;198502";83312;2240735
22/8/2022;101;Entrada;"Ingresos por ventas ;1008760;198503";80923;2321658
22/8/2022;202;Entrada;"Ingresos por ventas;1008782;198505";79800;2401458
22/8/2022;301;Salida;"Gastos administrativos;1008603;198501";84558;2316900
22/8/2022;201;Salida;"Gastos en servicios;1008656;198504";22688;2294212
30/8/2022;301;Salida;"Gastos administrativos;1008678;198502";81971;2212241
30/8/2022;101;Entrada;"Ingresos por ventas ;1008699;198503";90119;2302360
30/8/2022;202;Entrada;"Ingresos por ventas;1008721;198502";55984;2358344
30/8/2022;201;Salida;"Gastos en servicios;1008761;198502";33478;2324866
30/8/2022;301;Salida;"Gastos administrativos;1008783;198504";77692;2247174
30/8/2022;101;Entrada;"Ingresos por ventas ;1008604;198505";94926;2342100
30/8/2022;301;Salida;"Gastos administrativos;1008634;198501";75935;2266165
30/8/2022;202;Entrada;"Ingresos por ventas;1008657;198505";58116;2324281
2/9/2022;201;Salida;"Gastos en servicios;1008700;198502";44325;2279956
2/9/2022;301;Salida;"Gastos administrativos;1008722;198501";88616;2191340
2/9/2022;202;Entrada;"Ingresos por ventas;1008762;198501";92091;2283431
2/9/2022;101;Entrada;"Ingresos por ventas ;1008784;198501";87797;2371228
5/9/2022;201;Salida;"Gastos en servicios;1008605;198503";46459;2324769
5/9/2022;101;Entrada;"Ingresos por ventas ;1008635;198505";58086;2382855
5/9/2022;301;Entrada;"Ingresos por ventas;1008658;198501";59272;2442127
5/9/2022;202;Entrada;"Ingresos por ventas;1008701;198501";72434;2514561
6/9/2022;301;Salida;"Gastos administrativos;1008742;198503";22885;2491676
6/9/2022;301;Salida;"Gastos administrativos;1008763;198505";22456;2469220
6/9/2022;202;Entrada;"Ingresos por ventas;1008606;198505";71486;2540706
6/9/2022;201;Salida;"Gastos en servicios;1008636;198502";91006;2449700
7/9/2022;101;Entrada;"Ingresos por ventas ;1008679;198502";60843;2510543
7/9/2022;301;Salida;"Gastos administrativos;1008702;198505";22920;2487623
7/9/2022;101;Entrada;"Ingresos por ventas ;1008743;198503";84320;2571943
7/9/2022;101;Entrada;"Ingresos por ventas ;1008764;198505";71977;2643920
11/9/2022;202;Entrada;"Ingresos por ventas;1008637;198505";77751;2721671
11/9/2022;201;Salida;"Gastos en servicios;1008680;198503";46356;2675315
11/9/2022;101;Entrada;"Ingresos por ventas ;1008703;198501";85195;2760510
11/9/2022;101;Entrada;"Ingresos por ventas ;1008723;198501";75129;2835639
21/9/2022;201;Salida;"Gastos en servicios;1008744;198505";46625;2789014
21/9/2022;201;Salida;"Gastos en servicios;1008785;198505";47224;2741790
21/9/2022;301;Salida;"Gastos administrativos;1008638;198504";55725;2686065
22/9/2022;101;Entrada;"Ingresos por ventas ;1008659;198501";80002;2766067
23/9/2022;202;Entrada;"Ingresos por ventas;1008681;198505";87695;2853762
24/9/2022;201;Salida;"Gastos en servicios;1008724;198501";54190;2799572
24/9/2022;202;Entrada;"Ingresos por ventas;1008745;198504";60068;2859640
26/9/2022;202;Entrada;"Ingresos por ventas;1008786;198504";73772;2933412
26/9/2022;301;Salida;"Gastos administrativos;1008607;198503";33815;2899597
27/9/2022;201;Salida;"Gastos en servicios;1008660;198503";91299;2808298
27/9/2022;301;Salida;"Gastos administrativos;1008682;198501";22014;2786284
27/9/2022;202;Entrada;"Ingresos por ventas;1008725;198504";59909;2846193
27/9/2022;301;Salida;"Gastos administrativos;1008746;198501";58017;2788176
1/10/2022;201;Salida;"Gastos en servicios;1008765;198504";22932;2765244
1/10/2022;301;Salida;"Gastos administrativos;1008787;198502";21360;2743884
5/10/2022;101;Entrada;"Ingresos por ventas ;1008608;198503";92268;2836152
5/10/2022;202;Entrada;"Ingresos por ventas;1008661;198504";84245;2920397
8/10/2022;101;Entrada;"Ingresos por ventas ;1008683;198501";79715;3000112
8/10/2022;201;Salida;"Gastos en servicios;1008704;198503";54839;2945273
15/10/2022;301;Salida;"Gastos administrativos;1008726;198503";33604;2911669
15/10/2022;202;Entrada;"Ingresos por ventas;1008766;198505";78060;2989729
15/10/2022;101;Entrada;"Ingresos por ventas ;1008788;198503";55581;3045310
15/10/2022;201;Salida;"Gastos en servicios;1008609;198502";92897;2952413
30/10/2022;101;Entrada;"Ingresos por ventas ;1008639;198504";57571;3009984
30/10/2022;301;Salida;"Gastos administrativos;1008662;198502";57571;2952413
1/11/2022;202;Entrada;"Ingresos por ventas;1008705;198501";60247;3012660
1/11/2022;101;Entrada;"Ingresos por ventas ;1008727;198505";95069;3107729
24/11/2022;301;Salida;"Gastos administrativos;1008767;198505";55846;3051883
24/11/2022;201;Salida;"Gastos en servicios;1008789;198502";56688;2995195
29/11/2022;202;Entrada;"Ingresos por ventas;1008610;198503";85053;3080248
29/11/2022;201;Salida;"Gastos en servicios;1008640;198504";54629;3025619
4/12/2022;301;Salida;"Gastos administrativos;1008706;198504";85078;2940541
4/12/2022;101;Entrada;"Ingresos por ventas ;1008747;198503";67856;3008397
